Rk,Player,Pos,Age,Tm,G,GS,MP,FG,FGA,FG%,3P,3PA,3P%,2P,2PA,2P%,eFG%,FT,FTA,FT%,ORB,DRB,TRB,AST,STL,BLK,TOV,PF,PTS
1,Steven Adams\adamsst01,C,26,OKC,28,28,777,144,229,.629,0,1,.000,144,228,.632,.629,40,82,.488,95,180,275,79,16,35,44,55,328
2,Bam Adebayo\adebaba01,C,22,MIA,31,31,1059,181,316,.573,1,9,.111,180,307,.586,.574,126,183,.689,82,252,334,145,45,39,89,81,489
3,LaMarcus Aldridge\aldrila01,C,34,SAS,28,28,923,220,428,.514,18,51,.353,202,377,.536,.535,82,99,.828,59,147,206,69,18,53,41,63,540
4,Nickeil Alexander-Walker\alexani01,SG,21,NOP,26,0,337,53,160,.331,28,84,.333,25,76,.329,.419,11,16,.688,4,50,54,46,9,4,26,30,145
5,Grayson Allen\allengr01,SG,24,MEM,17,0,308,51,114,.447,23,57,.404,28,57,.491,.548,16,19,.842,2,39,41,25,5,1,16,25,141
6,Jarrett Allen\allenja01,C,21,BRK,30,27,796,141,215,.656,0,2,.000,141,213,.662,.656,79,128,.617,108,204,312,41,22,41,36,75,361
7,Kadeem Allen\allenka01,SG,27,NYK,2,0,18,3,7,.429,3,5,.600,0,2,.000,.643,0,0,,0,0,0,2,1,0,2,2,9
8,Al-Farouq Aminu\aminual01,PF,29,ORL,18,2,380,25,86,.291,9,36,.250,16,50,.320,.343,19,29,.655,24,63,87,21,18,8,17,27,78
9,Kyle Anderson\anderky01,PF,26,MEM,26,1,476,58,122,.475,5,21,.238,53,101,.525,.496,22,35,.629,25,84,109,63,17,14,24,41,143
10,Ryan Anderson\anderry01,PF,31,HOU,2,0,14,2,7,.286,1,5,.200,1,2,.500,.357,0,0,,0,7,7,2,1,0,1,1,5
11,Giannis Antetokounmpo\antetgi01,PF,25,MIL,31,31,963,352,635,.554,52,159,.327,300,476,.630,.595,191,320,.597,82,319,401,176,40,37,113,96,947
12,Kostas Antetokounmpo\antetko01,PF,22,LAL,2,0,3,0,0,,0,0,,0,0,,,0,0,,0,1,1,0,0,0,0,0,0
13,Thanasis Antetokounmpo\antetth01,SF,27,MIL,7,0,39,9,15,.600,0,1,.000,9,14,.643,.600,4,8,.500,5,1,6,6,1,1,2,5,22
14,Carmelo Anthony\anthoca01,PF,35,POR,17,17,528,103,245,.420,27,68,.397,76,177,.429,.476,42,52,.808,20,89,109,19,21,13,34,52,275
15,OG Anunoby\anunoog01,SF,22,TOR,30,30,906,134,268,.500,41,113,.363,93,155,.600,.576,30,48,.625,31,143,174,49,34,26,38,74,339
16,Ryan Arcidiacono\arcidry01,PG,25,CHI,32,0,491,44,112,.393,28,67,.418,16,45,.356,.518,18,24,.750,14,41,55,50,14,2,18,54,134
17,Trevor Ariza\arizatr01,SF,34,SAC,23,0,550,43,115,.374,29,84,.345,14,31,.452,.500,12,15,.800,16,87,103,31,24,6,21,43,127
18,D.J. Augustin\augusdj01,PG,32,ORL,31,6,796,100,256,.391,35,106,.330,65,150,.433,.459,74,82,.902,13,61,74,143,20,1,40,34,309
19,Deandre Ayton\aytonde01,C,21,PHO,2,2,58,18,33,.545,0,0,,18,33,.545,.545,0,1,.000,10,13,23,3,1,5,2,4,36
20,Dwayne Bacon\bacondw01,SG,24,CHO,24,10,407,50,162,.309,10,45,.222,40,117,.342,.340,24,35,.686,10,46,56,28,17,2,21,32,134
21,Marvin Bagley\baglema01,PF,20,SAC,9,3,212,50,109,.459,3,14,.214,47,95,.495,.472,20,25,.800,18,44,62,6,4,8,13,26,123
22,Lonzo Ball\balllo01,PG,22,NOP,24,15,666,91,243,.374,46,138,.333,45,105,.429,.469,14,28,.500,26,93,119,124,30,6,62,46,242
23,Mo Bamba\bambamo01,C,21,ORL,28,0,436,67,149,.450,20,55,.364,47,94,.500,.517,10,15,.667,42,102,144,17,9,37,28,55,164
24,J.J. Barea\bareajo01,PG,35,DAL,7,0,97,25,56,.446,12,22,.545,13,34,.382,.554,2,2,1.000,2,10,12,22,2,1,5,5,64
25,Harrison Barnes\barneha02,PF,27,SAC,31,31,1094,163,372,.438,43,124,.347,120,248,.484,.496,111,136,.816,32,128,160,70,22,5,44,39,480
26,RJ Barrett\barrerj01,SG,19,NYK,31,31,981,160,411,.389,33,107,.308,127,304,.418,.429,73,133,.549,34,130,164,88,34,13,67,69,426
27,Will Barton\bartowi01,SF,29,DEN,28,28,921,155,340,.456,46,117,.393,109,223,.489,.524,47,64,.734,46,151,197,95,32,11,42,57,403
28,Keita Bates-Diop\bateske01,SF,24,MIN,18,0,323,44,96,.458,20,49,.408,24,47,.511,.563,14,21,.667,8,38,46,8,8,7,6,16,122
29,Nicolas Batum\batumni01,SF,31,CHO,16,2,357,20,54,.370,11,36,.306,9,18,.500,.472,6,6,1.000,18,47,65,48,13,8,19,32,57
30,Aron Baynes\baynear01,C,33,PHO,22,16,519,109,211,.517,33,89,.371,76,122,.623,.595,32,44,.727,32,90,122,50,5,15,28,84,283
31,Kent Bazemore\bazemke01,SF,30,POR,32,11,784,86,238,.361,43,120,.358,43,118,.364,.452,42,51,.824,10,115,125,46,31,23,48,90,257
32,Darius Bazley\bazleda01,PF,19,OKC,31,4,524,42,122,.344,18,64,.281,24,58,.414,.418,13,20,.650,11,104,115,17,12,19,27,34,115
33,Bradley Beal\bealbr01,SG,26,WAS,30,30,1099,285,653,.436,77,243,.317,208,410,.507,.495,188,227,.828,34,111,145,200,33,10,101,74,835
34,Malik Beasley\beaslma01,SG,23,DEN,23,0,371,60,152,.395,32,79,.405,28,73,.384,.500,7,9,.778,6,30,36,23,10,4,20,27,159
35,Marco Belinelli\belinma01,SG,33,SAS,28,0,465,58,163,.356,29,84,.345,29,79,.367,.445,22,30,.733,1,47,48,35,7,0,11,24,167
36,Jordan Bell\belljo01,C,25,MIN,18,0,181,24,45,.533,0,5,.000,24,40,.600,.533,16,25,.640,22,39,61,12,2,9,15,13,64
37,DeAndre' Bembry\bembrde01,SG,25,ATL,31,4,698,82,175,.469,11,45,.244,71,130,.546,.500,20,39,.513,30,93,123,70,38,14,42,57,195
38,Dragan Bender\bendedr01,SF,22,MIL,3,0,29,6,8,.750,2,4,.500,4,4,1.000,.875,1,1,1.000,0,2,2,3,0,2,1,6,15
39,Dāvis Bertāns\bertada01,PF,27,WAS,28,4,839,142,316,.449,105,242,.434,37,74,.500,.616,42,47,.894,25,113,138,48,18,18,22,72,431
40,Patrick Beverley\beverpa01,PG,31,LAC,28,28,816,83,204,.407,40,123,.325,43,81,.531,.505,15,26,.577,35,135,170,95,40,18,36,96,221
41,Khem Birch\birchkh01,C,27,ORL,18,11,393,30,61,.492,0,1,.000,30,60,.500,.492,14,30,.467,35,59,94,19,10,13,13,44,74
42,Goga Bitadze\bitadgo01,C,20,IND,24,2,248,29,63,.460,4,15,.267,25,48,.521,.492,14,19,.737,17,41,58,15,1,22,13,40,76
43,Bismack Biyombo\biyombi01,C,27,CHO,32,17,601,100,175,.571,0,0,,100,175,.571,.571,57,97,.588,75,107,182,30,6,25,21,72,257
44,Nemanja Bjelica\bjeline01,PF,31,SAC,31,28,813,135,288,.469,54,134,.403,81,154,.526,.563,26,28,.929,50,136,186,82,27,19,46,90,350
45,Eric Bledsoe\bledser01,PG,30,MIL,26,26,693,147,308,.477,32,93,.344,115,215,.535,.529,65,80,.813,21,107,128,147,22,12,60,60,391
46,Bogdan Bogdanović\bogdabo01,SG,27,SAC,26,0,737,138,329,.419,70,183,.383,68,146,.466,.526,37,55,.673,8,67,75,99,31,5,51,51,383
47,Bojan Bogdanović\bogdabo02,SF,30,UTA,30,30,1008,205,462,.444,96,220,.436,109,242,.450,.548,123,138,.891,18,116,134,64,19,4,85,58,629
48,Jonah Bolden\boldejo01,PF,24,PHI,2,0,5,1,1,1.000,0,0,,1,1,1.000,1.000,0,2,.000,0,0,0,0,1,0,1,0,2
49,Jordan Bone\bonejo01,PG,22,DET,3,0,6,2,5,.400,0,1,.000,2,4,.500,.400,0,0,,0,0,0,0,0,0,2,2,4
50,Isaac Bonga\bongais01,SF,20,WAS,25,19,390,32,69,.464,5,18,.278,27,51,.529,.500,17,23,.739,20,48,68,29,15,5,16,53,86
51,Devin Booker\bookede01,SG,23,PHO,28,28,994,241,483,.499,56,150,.373,185,333,.556,.557,145,160,.906,19,91,110,176,19,8,110,85,683
52,Chris Boucher\bouchch01,PF,27,TOR,28,0,352,58,126,.460,15,44,.341,43,82,.524,.520,45,59,.763,54,64,118,11,9,23,10,44,176
53,Brian Bowen\bowenbr02,SG,21,IND,3,0,10,1,4,.250,0,1,.000,1,3,.333,.250,0,0,,0,1,1,0,0,1,0,0,2
54,Ky Bowman\bowmaky01,PG,22,GSW,29,6,661,92,211,.436,28,72,.389,64,139,.460,.502,22,24,.917,15,64,79,84,24,5,36,63,234
55,Avery Bradley\bradlav01,SG,29,LAL,17,12,413,57,132,.432,11,46,.239,46,86,.535,.473,7,10,.700,11,35,46,23,14,1,19,40,132
56,Tony Bradley\bradlto01,C,22,UTA,20,2,170,34,55,.618,0,0,,34,55,.618,.618,11,16,.688,25,40,65,5,2,8,10,33,79
57,Jarrell Brantley\brantja01,PF,23,UTA,2,0,9,0,0,,0,0,,0,0,,,0,0,,0,4,4,1,0,2,1,1,0
58,Ignas Brazdeikis\brazdig01,SF,21,NYK,8,0,48,5,20,.250,1,8,.125,4,12,.333,.275,3,4,.750,2,3,5,2,0,1,2,3,14
59,Mikal Bridges\bridgmi01,SF,23,PHO,31,3,672,75,153,.490,16,52,.308,59,101,.584,.542,44,55,.800,28,92,120,40,41,11,25,56,210
60,Miles Bridges\bridgmi02,SF,21,CHO,34,34,1038,161,366,.440,52,146,.356,109,220,.495,.511,42,55,.764,39,136,175,59,20,26,53,75,416
61,Oshae Brissett\brissos01,SF,21,TOR,6,0,21,1,3,.333,1,1,1.000,0,2,.000,.500,0,0,,0,1,1,1,1,1,2,1,3
62,Ryan Broekhoff\broekry01,SG,29,DAL,8,0,63,9,20,.450,8,15,.533,1,5,.200,.650,5,6,.833,0,11,11,4,1,0,2,6,31
63,Malcolm Brogdon\brogdma01,PG,27,IND,26,26,816,171,378,.452,37,111,.333,134,267,.502,.501,98,105,.933,17,101,118,198,23,5,71,54,477
64,Dillon Brooks\brookdi01,SG,24,MEM,32,32,889,162,402,.403,57,154,.370,105,248,.423,.474,75,90,.833,31,81,112,65,35,12,50,118,456
65,Bruce Brown\brownbr01,SG,23,DET,31,26,820,100,223,.448,19,52,.365,81,171,.474,.491,38,59,.644,29,108,137,115,34,16,58,84,257
66,Charlie Brown\brownch02,SG,22,ATL,4,0,16,1,3,.333,1,1,1.000,0,2,.000,.500,4,4,1.000,2,1,3,0,0,1,0,0,7
67,Jaylen Brown\brownja02,SF,23,BOS,26,26,869,201,386,.521,57,143,.399,144,243,.593,.595,79,105,.752,26,157,183,63,27,9,52,81,538
68,Moses Brown\brownmo01,C,20,POR,4,0,15,3,7,.429,0,0,,3,7,.429,.429,2,4,.500,2,7,9,0,1,0,1,4,8
69,Sterling Brown\brownst02,SF,24,MIL,24,0,415,47,122,.385,22,63,.349,25,59,.424,.475,18,25,.720,14,82,96,27,17,3,24,31,134
70,Troy Brown\browntr01,SG,20,WAS,27,11,640,100,212,.472,17,55,.309,83,157,.529,.512,36,47,.766,35,110,145,61,35,4,28,44,253
71,Jalen Brunson\brunsja01,PG,23,DAL,30,7,546,101,208,.486,25,71,.352,76,137,.555,.546,31,41,.756,16,65,81,112,14,1,38,40,258
72,Thomas Bryant\bryanth01,C,22,WAS,18,18,511,101,184,.549,10,35,.286,91,149,.611,.576,39,53,.736,42,111,153,48,8,18,24,44,251
73,Trey Burke\burketr01,PG,27,PHI,15,0,215,37,81,.457,11,24,.458,26,57,.456,.525,11,14,.786,11,13,24,36,7,1,8,13,96
74,Alec Burks\burksal01,SG,28,GSW,30,12,875,157,369,.425,45,129,.349,112,240,.467,.486,106,120,.883,21,116,137,93,37,9,45,65,465
75,Deonte Burton\burtode02,SG,26,OKC,16,0,145,17,48,.354,5,23,.217,12,25,.480,.406,3,5,.600,4,21,25,5,1,3,4,13,42
76,Jimmy Butler\butleji01,SF,30,MIA,27,27,950,159,369,.431,24,85,.282,135,284,.475,.463,208,250,.832,55,122,177,178,56,16,71,37,550
77,Bruno Caboclo\cabocbr01,SF,24,MEM,19,0,187,28,66,.424,4,23,.174,24,43,.558,.455,2,3,.667,16,26,42,10,10,12,7,21,62
78,Kentavious Caldwell-Pope\caldwke01,SG,26,LAL,31,19,781,105,224,.469,39,98,.398,66,126,.524,.556,30,39,.769,19,48,67,56,26,5,28,54,279
79,Vlatko Čančar\cancavl01,SF,22,DEN,3,0,5,0,1,.000,0,0,,0,1,.000,.000,2,2,1.000,1,0,1,1,0,0,0,0,2
80,Clint Capela\capelca01,C,25,HOU,27,27,907,170,265,.642,0,0,,170,265,.642,.642,34,70,.486,108,280,388,32,24,52,46,74,374
81,DeMarre Carroll\carrode01,SF,33,SAS,13,0,131,9,28,.321,3,13,.231,6,15,.400,.375,11,18,.611,7,23,30,10,2,2,10,19,32
82,Jevon Carter\carteje01,PG,24,PHO,21,2,309,29,80,.363,16,46,.348,13,34,.382,.463,6,8,.750,11,33,44,37,20,6,17,34,80
83,Vince Carter\cartevi01,SF,43,ATL,26,0,407,52,147,.354,29,97,.299,23,50,.460,.452,8,13,.615,5,43,48,26,8,9,14,44,141
84,Wendell Carter\cartewe01,C,20,CHI,32,32,965,145,264,.549,3,19,.158,142,245,.580,.555,82,114,.719,109,205,314,33,25,29,50,128,375
85,Michael Carter-Williams\cartemi01,SG,28,ORL,19,0,310,35,93,.376,7,30,.233,28,63,.444,.414,22,31,.710,18,42,60,38,20,8,17,27,99
86,Alex Caruso\carusal01,PG,25,LAL,29,0,583,56,129,.434,20,59,.339,36,70,.514,.512,25,33,.758,6,55,61,49,31,8,26,43,157
87,Willie Cauley-Stein\caulewi01,C,26,GSW,30,29,705,112,195,.574,0,0,,112,195,.574,.574,25,41,.610,46,142,188,43,38,43,28,83,249
88,Tyson Chandler\chandty01,C,37,HOU,21,4,178,13,17,.765,0,0,,13,17,.765,.765,5,9,.556,21,35,56,6,5,7,7,25,31
89,Wilson Chandler\chandwi01,SF,32,BRK,5,0,100,11,29,.379,1,14,.071,10,15,.667,.397,2,2,1.000,1,22,23,7,3,1,7,10,25
90,Zylan Cheatham\cheatzy01,SF,24,NOP,2,0,20,1,4,.250,0,1,.000,1,3,.333,.250,0,0,,0,3,3,1,0,0,1,3,2
91,Chris Chiozza\chiozch01,PG,24,WAS,10,0,123,10,34,.294,7,16,.438,3,18,.167,.397,0,0,,0,15,15,28,10,2,9,12,27
92,Marquese Chriss\chrisma01,PF,22,GSW,32,1,550,81,166,.488,4,21,.190,77,145,.531,.500,61,76,.803,55,114,169,55,19,28,48,63,227
93,Gary Clark\clarkga01,PF,25,HOU,16,0,184,20,54,.370,15,46,.326,5,8,.625,.509,6,7,.857,9,22,31,10,2,6,1,19,61
94,Brandon Clarke\clarkbr01,PF,23,MEM,26,2,554,143,221,.647,15,32,.469,128,189,.677,.681,30,40,.750,37,111,148,32,11,21,27,44,331
95,Jordan Clarkson\clarkjo01,SG,27,TOT,30,0,687,148,338,.438,60,165,.364,88,173,.509,.527,76,86,.884,21,48,69,70,18,8,40,36,432
95,Jordan Clarkson\clarkjo01,SG,27,CLE,29,0,666,144,326,.442,59,159,.371,85,167,.509,.532,76,86,.884,21,48,69,70,17,8,39,33,423
95,Jordan Clarkson\clarkjo01,G,27,UTA,1,0,21,4,12,.333,1,6,.167,3,6,.500,.375,0,0,,0,0,0,0,1,0,1,3,9
96,Nicolas Claxton\claxtni01,PF,20,BRK,9,0,119,11,21,.524,0,5,.000,11,16,.688,.524,5,12,.417,8,14,22,11,1,5,6,10,27
97,Chris Clemons\clemoch01,SG,22,HOU,20,0,164,34,79,.430,25,64,.391,9,15,.600,.589,3,4,.750,2,12,14,6,5,4,8,16,96
98,John Collins\collijo01,PF,22,ATL,7,7,222,48,95,.505,12,30,.400,36,65,.554,.568,13,18,.722,13,57,70,10,7,15,9,26,121
99,Zach Collins\colliza01,PF,22,POR,3,3,86,9,19,.474,3,7,.429,6,12,.500,.553,6,6,1.000,4,8,12,6,0,2,6,11,27
100,Mike Conley\conlemi01,PG,32,UTA,22,22,647,99,271,.365,40,111,.360,59,160,.369,.439,61,76,.803,16,57,73,102,16,4,45,48,299
101,Pat Connaughton\connapa01,SG,27,MIL,31,0,535,59,131,.450,21,67,.313,38,64,.594,.531,15,21,.714,17,106,123,58,11,16,22,27,154
102,Quinn Cook\cookqu01,PG,26,LAL,21,0,284,43,103,.417,12,37,.324,31,66,.470,.476,4,5,.800,4,21,25,31,6,1,19,14,102
103,Tyler Cook\cookty01,PF,22,CLE,6,0,17,5,6,.833,0,0,,5,6,.833,.833,2,2,1.000,3,2,5,0,1,0,1,1,12
104,Robert Covington\covinro01,PF,29,MIN,29,28,810,121,280,.432,56,170,.329,65,110,.591,.532,52,60,.867,19,138,157,30,40,26,45,89,350
105,Allen Crabbe\crabbal01,SG,27,ATL,19,1,366,40,101,.396,21,66,.318,19,35,.543,.500,9,12,.750,8,39,47,17,12,3,8,20,110
106,Torrey Craig\craigto01,SF,29,DEN,21,2,259,24,61,.393,7,29,.241,17,32,.531,.451,7,13,.538,13,31,44,15,7,12,8,35,62
107,Jae Crowder\crowdja01,SF,29,MEM,31,31,959,106,291,.364,59,199,.296,47,92,.511,.466,48,64,.750,26,165,191,89,28,11,41,64,319
108,Jarrett Culver\culveja01,SG,20,MIN,29,16,637,89,247,.360,23,98,.235,66,149,.443,.407,24,56,.429,30,61,91,57,25,16,33,55,225
109,Seth Curry\curryse01,SG,29,DAL,28,9,604,91,197,.462,46,115,.400,45,82,.549,.579,38,41,.927,12,45,57,52,14,4,31,46,266
110,Stephen Curry\curryst01,PG,31,GSW,4,4,112,27,66,.409,9,37,.243,18,29,.621,.477,18,18,1.000,4,16,20,26,5,2,15,10,81
111,Troy Daniels\danietr01,SG,28,LAL,23,0,303,38,100,.380,25,73,.342,13,27,.481,.505,4,7,.571,4,24,28,8,7,1,6,17,105
112,Anthony Davis\davisan02,PF,26,LAL,29,29,1017,282,566,.498,32,110,.291,250,456,.548,.527,208,243,.856,72,198,270,94,41,77,69,75,804
113,Ed Davis\davised01,C,30,UTA,19,0,219,11,28,.393,0,0,,11,28,.393,.393,4,9,.444,21,60,81,8,9,8,12,46,26
114,Terence Davis\daviste02,SG,22,TOR,31,0,501,72,156,.462,34,86,.395,38,70,.543,.571,23,24,.958,16,73,89,57,15,6,26,51,201
115,Dewayne Dedmon\dedmode01,C,30,SAC,23,4,312,44,105,.419,11,48,.229,33,57,.579,.471,11,13,.846,26,62,88,8,9,12,32,55,110
116,Matthew Dellavedova\dellama01,PG,29,CLE,29,0,386,27,86,.314,6,47,.128,21,39,.538,.349,19,20,.950,11,29,40,78,11,1,23,44,79
117,DeMar DeRozan\derozde01,SF,30,SAS,30,30,1012,240,471,.510,5,19,.263,235,452,.520,.515,141,173,.815,16,144,160,146,29,12,77,87,626
118,Cheick Diallo\diallch01,C,23,PHO,20,0,190,45,65,.692,1,1,1.000,44,64,.688,.700,18,21,.857,14,41,55,10,2,4,12,21,109
119,Hamidou Diallo\diallha01,SF,21,OKC,12,1,256,46,92,.500,2,13,.154,44,79,.557,.511,11,18,.611,14,32,46,10,18,4,14,29,105
120,Gorgui Dieng\dienggo01,C,30,MIN,26,7,415,61,137,.445,21,56,.375,40,81,.494,.522,28,36,.778,34,98,132,25,21,25,19,45,171
121,Spencer Dinwiddie\dinwisp01,SG,26,BRK,30,19,918,224,518,.432,59,191,.309,165,327,.505,.489,175,212,.825,7,84,91,183,25,12,83,100,682
122,Donte DiVincenzo\divindo01,SG,23,MIL,30,17,665,95,219,.434,34,102,.333,61,117,.521,.511,29,36,.806,26,105,131,65,48,8,33,52,253
123,Luka Dončić\doncilu01,PG,20,DAL,26,26,837,245,514,.477,77,239,.322,168,275,.611,.552,189,237,.797,35,214,249,230,31,3,112,60,756
124,Luguentz Dort\dortlu01,SG,20,OKC,6,0,98,7,19,.368,1,11,.091,6,8,.750,.395,5,9,.556,1,8,9,3,2,0,2,15,20
125,Damyean Dotson\dotsoda01,SG,25,NYK,28,0,469,65,159,.409,31,97,.320,34,62,.548,.506,16,23,.696,4,43,47,37,12,4,13,23,177
126,Sekou Doumbouya\doumbse01,SF,19,DET,6,0,22,4,11,.364,0,3,.000,4,8,.500,.364,1,3,.333,0,4,4,0,1,0,1,3,9
127,Goran Dragić\dragigo01,PG,33,MIA,21,1,601,114,250,.456,48,116,.414,66,134,.493,.552,58,81,.716,7,61,68,105,14,5,53,35,334
128,Andre Drummond\drumman01,C,26,DET,30,29,1007,225,405,.556,0,15,.000,225,390,.577,.556,86,140,.614,132,345,477,83,57,51,108,111,536
129,Jared Dudley\dudleja01,SF,34,LAL,21,1,178,11,27,.407,10,19,.526,1,8,.125,.593,2,2,1.000,2,16,18,14,8,1,3,20,34
130,Kris Dunn\dunnkr01,PG,25,CHI,32,13,749,95,219,.434,16,69,.232,79,150,.527,.470,20,29,.690,17,93,110,102,66,12,36,114,226
131,Carsen Edwards\edwarca01,SG,21,BOS,23,0,244,27,85,.318,17,52,.327,10,33,.303,.418,11,13,.846,5,32,37,17,8,2,13,23,82
132,Henry Ellenson\ellenhe01,PF,23,BRK,4,0,14,1,7,.143,0,4,.000,1,3,.333,.143,0,0,,2,2,4,0,0,0,0,1,2
133,Wayne Ellington\ellinwa01,SG,32,NYK,18,1,257,26,81,.321,21,69,.304,5,12,.417,.451,4,6,.667,1,28,29,16,5,2,12,20,77
134,Joel Embiid\embiijo01,C,25,PHI,28,28,861,213,454,.469,36,108,.333,177,346,.512,.509,190,229,.830,73,277,350,89,23,40,85,96,652
135,James Ennis\ennisja01,SF,29,PHI,34,0,596,78,172,.453,31,82,.378,47,90,.522,.544,39,51,.765,40,80,120,33,14,11,22,66,226
136,Drew Eubanks\eubandr01,PF,22,SAS,4,0,31,5,10,.500,0,0,,5,10,.500,.500,1,1,1.000,5,8,13,2,0,1,4,4,11
137,Jacob Evans\evansja02,SG,22,GSW,12,0,161,17,56,.304,7,15,.467,10,41,.244,.366,12,13,.923,2,12,14,11,2,4,10,19,53
138,Dante Exum\exumda01,SG,24,TOT,12,0,98,13,26,.500,3,7,.429,10,19,.526,.558,4,6,.667,3,9,12,8,3,2,11,9,33
138,Dante Exum\exumda01,SG,24,UTA,11,0,83,10,23,.435,2,6,.333,8,17,.471,.478,2,2,1.000,3,9,12,7,1,2,10,8,24
138,Dante Exum\exumda01,G,24,CLE,1,0,15,3,3,1.000,1,1,1.000,2,2,1.000,1.167,2,4,.500,0,0,0,1,2,0,1,1,9
139,Tacko Fall\fallta01,C,24,BOS,3,0,11,6,8,.750,0,0,,6,8,.750,.750,1,2,.500,0,7,7,0,0,2,3,3,13
140,Derrick Favors\favorde01,C,28,NOP,16,14,353,60,107,.561,1,3,.333,59,104,.567,.565,7,15,.467,52,97,149,37,8,15,24,37,128
141,Terrance Ferguson\fergute01,SF,21,OKC,25,25,663,47,117,.402,31,90,.344,16,27,.593,.534,7,9,.778,16,33,49,25,14,6,19,85,132
142,Bruno Fernando\fernabr01,C,21,ATL,31,4,367,47,95,.495,4,22,.182,43,73,.589,.516,19,32,.594,34,65,99,32,8,11,29,52,117
143,Yogi Ferrell\ferreyo01,PG,26,SAC,24,0,333,46,106,.434,10,37,.270,36,69,.522,.481,28,32,.875,4,30,34,41,10,3,18,20,130
144,Dorian Finney-Smith\finnedo01,PF,26,DAL,30,27,852,97,198,.490,42,111,.378,55,87,.632,.596,32,45,.711,55,102,157,39,19,14,29,62,268
145,Bryn Forbes\forbebr01,SG,26,SAS,30,30,771,120,299,.401,66,185,.357,54,114,.474,.512,37,43,.860,8,64,72,53,13,0,25,54,343
146,Evan Fournier\fournev01,SG,27,ORL,31,31,952,211,440,.480,82,198,.414,129,242,.533,.573,93,115,.809,4,79,83,102,31,5,58,72,597
147,De'Aaron Fox\foxde01,PG,22,SAC,14,12,410,86,185,.465,15,45,.333,71,140,.507,.505,59,86,.686,13,43,56,89,16,5,48,38,246
148,Melvin Frazier\frazime01,SG,23,ORL,6,0,17,3,10,.300,2,4,.500,1,6,.167,.400,0,0,,1,1,2,1,0,0,0,3,8
149,Tim Frazier\fraziti01,PG,29,DET,18,6,225,23,63,.365,10,23,.435,13,40,.325,.444,17,20,.850,5,13,18,65,10,2,16,27,73
150,Markelle Fultz\fultzma01,PG,21,ORL,30,25,782,144,301,.478,14,51,.275,130,250,.520,.502,49,67,.731,12,72,84,126,34,7,58,60,351
151,Wenyen Gabriel\gabriwe01,PF,22,SAC,7,0,47,5,16,.313,1,8,.125,4,8,.500,.344,5,9,.556,4,4,8,3,2,2,3,6,16
152,Daniel Gafford\gaffoda01,C,21,CHI,22,0,240,40,55,.727,0,0,,40,55,.727,.727,13,25,.520,18,20,38,6,1,26,5,38,93
153,Danilo Gallinari\gallida01,PF,31,OKC,27,27,823,150,347,.432,75,190,.395,75,157,.478,.540,112,124,.903,14,139,153,59,19,4,39,39,487
154,Langston Galloway\gallola01,SG,28,DET,32,6,845,116,269,.431,71,174,.408,45,95,.474,.563,53,59,.898,13,56,69,45,21,8,23,39,356
155,Darius Garland\garlada01,PG,20,CLE,31,31,873,130,335,.388,54,147,.367,76,188,.404,.469,29,33,.879,13,50,63,90,20,0,78,43,343
156,Marc Gasol\gasolma01,C,35,TOR,27,27,762,63,173,.364,31,88,.352,32,85,.376,.454,21,28,.750,23,156,179,92,22,30,33,85,178
157,Rudy Gay\gayru01,PF,33,SAS,30,5,686,119,265,.449,29,96,.302,90,169,.533,.504,57,65,.877,33,145,178,57,15,20,47,42,324
158,Paul George\georgpa01,SF,29,LAC,22,22,681,172,393,.438,80,203,.394,92,190,.484,.539,101,111,.910,10,117,127,80,32,12,77,56,525
159,Taj Gibson\gibsota01,C,34,NYK,29,23,468,58,124,.468,2,10,.200,56,114,.491,.476,9,17,.529,52,76,128,34,18,10,22,62,127
160,Harry Giles\gilesha01,PF,21,SAC,7,0,52,11,25,.440,0,0,,11,25,.440,.440,2,2,1.000,3,4,7,5,2,3,5,13,24
161,Shai Gilgeous-Alexander\gilgesh01,SG,21,OKC,31,31,1092,218,483,.451,40,113,.354,178,370,.481,.493,125,155,.806,19,134,153,89,35,13,64,55,601
162,Rudy Gobert\goberru01,C,27,UTA,29,29,1001,168,244,.689,0,0,,168,244,.689,.689,99,164,.604,106,308,414,44,21,55,61,88,435
163,Brandon Goodwin\goodwbr01,PG,24,ATL,3,0,20,0,7,.000,0,5,.000,0,2,.000,.000,0,0,,0,3,3,2,1,0,2,2,0
164,Aaron Gordon\gordoaa01,PF,24,ORL,28,28,882,141,345,.409,32,109,.294,109,236,.462,.455,64,91,.703,51,154,205,83,18,17,43,59,378
165,Eric Gordon\gordoer01,SG,31,HOU,9,2,265,34,110,.309,21,74,.284,13,36,.361,.405,9,14,.643,3,14,17,7,5,2,12,21,98
166,Devonte' Graham\grahade01,PG,24,CHO,34,24,1180,207,542,.382,128,322,.398,79,220,.359,.500,110,138,.797,33,99,132,259,28,10,103,62,652
167,Treveon Graham\grahatr01,SG,26,MIN,28,19,587,56,160,.350,18,76,.237,38,84,.452,.406,24,34,.706,28,64,92,25,15,2,15,57,154
168,Jerami Grant\grantje01,PF,25,DEN,30,2,688,106,230,.461,41,100,.410,65,130,.500,.550,42,67,.627,14,83,97,28,14,18,25,55,295
169,Josh Gray\grayjo01,PG,26,NOP,2,0,23,1,2,.500,0,0,,1,2,.500,.500,0,0,,1,1,2,2,0,0,5,1,2
170,Danny Green\greenda02,SG,32,LAL,31,31,795,91,219,.416,61,161,.379,30,58,.517,.555,19,24,.792,22,95,117,38,36,16,31,71,262
171,Draymond Green\greendr01,PF,29,GSW,23,23,676,78,190,.411,18,63,.286,60,127,.472,.458,45,61,.738,15,133,148,126,37,16,55,60,219
172,JaMychal Green\greenja01,PF,29,LAC,24,0,494,58,143,.406,37,98,.378,21,45,.467,.535,18,21,.857,31,123,154,14,14,8,20,57,171
173,Javonte Green\greenja02,SF,26,BOS,23,0,182,29,51,.569,3,13,.231,26,38,.684,.598,4,7,.571,6,24,30,7,4,4,8,19,65
174,Jeff Green\greenje02,PF,33,UTA,30,2,553,75,195,.385,34,104,.327,41,91,.451,.472,49,63,.778,14,67,81,20,12,10,27,46,233
175,Blake Griffin\griffbl01,PF,30,DET,17,17,483,85,234,.363,24,101,.238,61,133,.459,.415,73,94,.777,17,65,82,57,7,7,40,25,267
176,Marko Guduric\gudurma01,SG,24,MEM,26,0,382,47,126,.373,18,64,.281,29,62,.468,.444,15,17,.882,12,41,53,36,9,6,28,25,127
177,Rui Hachimura\hachiru01,PF,21,WAS,25,25,729,146,303,.482,10,48,.208,136,255,.533,.498,46,54,.852,39,106,145,40,18,3,20,57,348
178,Devon Hall\hallde01,SG,24,OKC,5,0,20,1,5,.200,0,2,.000,1,3,.333,.200,3,4,.750,0,1,1,3,0,0,1,1,5
179,Tim Hardaway\hardati02,SG,27,DAL,30,17,787,143,347,.412,77,207,.372,66,140,.471,.523,49,61,.803,10,71,81,53,18,3,28,52,412
180,James Harden\hardeja01,SG,30,HOU,31,31,1166,343,759,.452,159,427,.372,184,332,.554,.557,337,385,.875,31,148,179,234,59,22,147,104,1182
181,Maurice Harkless\harklma01,SF,26,LAC,33,22,771,74,149,.497,18,52,.346,56,97,.577,.557,19,33,.576,31,87,118,37,38,22,31,87,185
182,Jared Harper\harpeja01,PG,22,PHO,1,0,2,0,1,.000,0,1,.000,0,0,,.000,0,0,,0,0,0,0,0,0,0,0,0
183,Montrezl Harrell\harremo01,C,26,LAC,33,2,964,257,447,.575,0,12,.000,257,435,.591,.575,112,169,.663,97,149,246,62,24,38,63,77,626
184,Gary Harris\harriga01,SG,25,DEN,30,30,983,128,294,.435,45,130,.346,83,164,.506,.512,39,48,.813,16,68,84,67,41,8,29,68,340
185,Joe Harris\harrijo01,SF,28,BRK,30,30,948,164,345,.475,81,189,.429,83,156,.532,.593,28,37,.757,26,96,122,63,19,10,42,72,437
186,Tobias Harris\harrito02,PF,27,PHI,34,34,1166,266,541,.492,55,158,.348,211,383,.551,.543,89,113,.788,28,200,228,107,29,24,61,81,676
187,Shaquille Harrison\harrish01,SF,26,CHI,18,4,147,20,49,.408,3,10,.300,17,39,.436,.439,11,18,.611,6,24,30,22,8,4,6,17,54
188,Josh Hart\hartjo01,SF,24,NOP,25,4,695,95,227,.419,58,157,.369,37,70,.529,.546,35,43,.814,23,127,150,35,24,7,33,67,283
189,Isaiah Hartenstein\harteis01,C,21,HOU,9,0,103,11,16,.688,0,1,.000,11,15,.733,.688,9,11,.818,8,18,26,5,3,4,6,17,31
190,Udonis Haslem\hasleud01,PF,39,MIA,2,0,11,1,1,1.000,0,0,,1,1,1.000,1.000,3,4,.750,0,3,3,0,0,0,0,3,5
191,Jaxson Hayes\hayesja02,C,19,NOP,29,10,601,93,148,.628,1,4,.250,92,144,.639,.632,59,92,.641,55,80,135,25,19,33,26,90,246
192,Gordon Hayward\haywago01,SF,29,BOS,13,13,391,89,162,.549,17,45,.378,72,117,.615,.602,19,24,.792,8,69,77,59,10,5,23,25,214
193,John Henson\hensojo01,PF,29,CLE,13,0,166,22,42,.524,2,11,.182,20,31,.645,.548,6,17,.353,11,28,39,17,8,18,10,21,52
194,Dewan Hernandez\hernade01,C,23,TOR,4,0,11,1,5,.200,0,1,.000,1,4,.250,.200,2,2,1.000,2,5,7,0,1,0,1,6,4
195,Juan Hernangómez\hernaju01,PF,24,DEN,18,0,225,25,64,.391,12,39,.308,13,25,.520,.484,7,13,.538,11,30,41,11,1,3,10,15,69
196,Willy Hernangómez\hernawi01,C,25,CHO,10,0,67,10,25,.400,2,7,.286,8,18,.444,.440,4,8,.500,9,14,23,3,1,3,6,4,26
197,Tyler Herro\herroty01,SG,20,MIA,30,3,860,151,358,.422,61,159,.384,90,199,.452,.507,53,61,.869,9,119,128,66,21,3,57,39,416
198,Kevin Hervey\herveke01,F,23,OKC,1,0,1,0,1,.000,0,0,,0,1,.000,.000,0,0,,0,0,0,0,0,0,0,0,0
199,Mario Hezonja\hezonma01,PF,24,POR,25,4,414,35,100,.350,10,32,.313,25,68,.368,.400,24,29,.828,16,92,108,22,13,2,20,55,104
200,Buddy Hield\hieldbu01,SG,27,SAC,31,31,1055,230,559,.411,113,318,.355,117,241,.485,.513,52,62,.839,28,127,155,89,26,9,76,78,625
201,George Hill\hillge01,PG,33,MIL,31,0,667,114,205,.556,50,94,.532,64,111,.577,.678,43,50,.860,30,69,99,92,25,3,28,45,321
202,Solomon Hill\hillso01,SF,28,MEM,30,2,592,68,163,.417,39,97,.402,29,66,.439,.537,13,20,.650,18,81,99,55,27,5,28,47,188
203,Jaylen Hoard\hoardja01,SF,20,POR,5,0,18,3,6,.500,0,0,,3,6,.500,.500,1,2,.500,3,4,7,2,1,0,0,1,7
204,Aaron Holiday\holidaa01,PG,23,IND,30,13,685,118,273,.432,49,119,.412,69,154,.448,.522,29,34,.853,11,65,76,94,26,3,39,51,314
205,Jrue Holiday\holidjr01,SG,29,NOP,30,30,1078,236,543,.435,58,170,.341,178,373,.477,.488,61,88,.693,42,110,152,196,54,21,96,68,591
206,Justin Holiday\holidju01,SG,30,IND,32,2,802,86,215,.400,50,134,.373,36,81,.444,.516,20,25,.800,16,103,119,48,35,18,17,52,242
207,Rondae Hollis-Jefferson\holliro01,SF,25,TOR,23,0,468,74,147,.503,2,9,.222,72,138,.522,.510,48,64,.750,54,67,121,38,19,10,24,45,198
208,Richaun Holmes\holmeri01,C,26,SAC,31,27,901,166,252,.659,0,0,,166,252,.659,.659,60,73,.822,96,176,272,34,35,42,38,127,392
209,Rodney Hood\hoodro01,SF,27,POR,21,21,619,87,172,.506,35,71,.493,52,101,.515,.608,21,27,.778,10,62,72,32,17,4,19,46,230
210,Al Horford\horfoal01,C,33,PHI,30,30,918,158,344,.459,42,123,.341,116,221,.525,.520,27,39,.692,50,151,201,117,32,31,34,70,385
211,Talen Horton-Tucker\hortota01,SG,19,LAL,2,0,5,0,1,.000,0,1,.000,0,0,,.000,0,0,,0,0,0,2,1,0,0,0,0
212,Danuel House\houseda01,SF,26,HOU,25,23,759,94,213,.441,56,141,.397,38,72,.528,.573,35,46,.761,30,69,99,32,26,14,22,57,279
213,Dwight Howard\howardw01,C,34,LAL,31,0,609,86,114,.754,1,3,.333,85,111,.766,.759,35,76,.461,70,146,216,23,12,40,40,110,208
214,Kevin Huerter\huertke01,SG,21,ATL,21,13,527,70,175,.400,38,103,.369,32,72,.444,.509,23,28,.821,11,59,70,70,20,9,33,45,201
215,De'Andre Hunter\huntede01,SF,22,ATL,31,30,985,143,355,.403,51,153,.333,92,202,.455,.475,58,76,.763,15,105,120,57,21,9,49,83,395
216,Chandler Hutchison\hutchch01,SF,23,CHI,9,6,154,20,44,.455,5,12,.417,15,32,.469,.511,19,29,.655,1,32,33,8,5,2,12,12,64
217,Serge Ibaka\ibakase01,C,30,TOR,21,4,505,112,236,.475,16,50,.320,96,186,.516,.508,46,57,.807,43,115,158,27,10,21,41,54,286
218,Ersan İlyasova\ilyaser01,PF,32,MIL,30,3,499,88,171,.515,26,73,.356,62,98,.633,.591,38,48,.792,37,114,151,25,14,10,16,45,240
219,Joe Ingles\inglejo01,SF,32,UTA,31,11,923,108,246,.439,62,156,.397,46,90,.511,.565,34,42,.810,14,122,136,130,30,4,64,73,312
220,Brandon Ingram\ingrabr01,PF,22,NOP,28,28,952,252,515,.489,66,161,.410,186,354,.525,.553,137,162,.846,24,175,199,105,25,22,81,83,707
221,Kyrie Irving\irvinky01,PG,27,BRK,11,11,372,112,252,.444,31,91,.341,81,161,.503,.506,59,63,.937,10,49,59,79,12,6,26,32,314
222,Jonathan Isaac\isaacjo01,SF,22,ORL,29,29,884,134,294,.456,29,86,.337,105,208,.505,.505,53,66,.803,46,157,203,40,39,75,45,74,350
223,Wesley Iwundu\iwundwe01,SF,25,ORL,17,3,233,16,55,.291,1,13,.077,15,42,.357,.300,17,20,.850,8,25,33,16,9,4,7,16,50
224,Frank Jackson\jacksfr01,PG,21,NOP,25,1,341,53,144,.368,20,68,.294,33,76,.434,.438,26,32,.813,5,27,32,22,9,1,23,36,152
225,Jaren Jackson\jacksja02,C,20,MEM,31,31,863,198,421,.470,80,199,.402,118,222,.532,.565,71,95,.747,32,108,140,49,21,41,56,126,547
226,Justin Jackson\jacksju01,PF,24,DAL,26,0,372,59,134,.440,24,66,.364,35,68,.515,.530,14,19,.737,10,51,61,14,5,2,4,30,156
227,Reggie Jackson\jacksre01,PG,29,DET,2,2,36,4,11,.364,1,5,.200,3,6,.500,.409,1,1,1.000,1,4,5,8,0,0,1,2,10
228,Justin James\jamesju01,SG,23,SAC,14,0,167,23,55,.418,6,19,.316,17,36,.472,.473,2,9,.222,3,20,23,11,4,7,7,12,54
229,LeBron James\jamesle01,PG,35,LAL,30,30,1048,298,607,.491,66,192,.344,232,415,.559,.545,108,159,.679,32,195,227,318,37,17,118,57,770
230,Amile Jefferson\jeffeam01,PF,26,ORL,7,0,19,3,4,.750,0,0,,3,4,.750,.750,0,2,.000,3,4,7,2,0,0,2,3,6
231,DaQuan Jeffries\jeffrda01,SG,22,SAC,2,0,11,1,1,1.000,0,0,,1,1,1.000,1.000,0,0,,1,0,1,1,0,0,0,1,2
232,Ty Jerome\jeromty01,PG,22,PHO,10,0,134,16,49,.327,6,20,.300,10,29,.345,.388,4,5,.800,3,14,17,22,11,0,9,13,42
233,Alize Johnson\johnsal02,SF,23,IND,9,0,39,5,11,.455,0,0,,5,11,.455,.455,3,4,.750,6,6,12,2,0,0,1,6,13
234,B.J. Johnson\johnsbj01,SF,24,ORL,1,0,3,0,0,,0,0,,0,0,,,0,0,,0,0,0,0,0,0,0,0,0
235,Cameron Johnson\johnsca02,PF,23,PHO,28,0,599,87,203,.429,57,141,.404,30,62,.484,.569,23,29,.793,28,64,92,30,16,8,18,45,254
236,James Johnson\johnsja01,PF,32,MIA,6,0,68,8,18,.444,2,9,.222,6,9,.667,.500,2,4,.500,2,9,11,4,3,2,4,5,20
237,Keldon Johnson\johnske04,SF,20,SAS,1,0,2,0,1,.000,0,0,,0,1,.000,.000,0,0,,0,0,0,0,0,0,0,0,0
238,Stanley Johnson\johnsst04,PF,23,TOR,6,0,23,6,13,.462,1,4,.250,5,9,.556,.500,0,0,,2,5,7,0,2,0,5,6,13
239,Tyler Johnson\johnsty01,SG,27,PHO,22,3,403,47,123,.382,19,61,.311,28,62,.452,.459,20,26,.769,8,35,43,43,8,7,20,33,133
240,Nikola Jokić\jokicni01,C,24,DEN,30,30,938,209,431,.485,38,124,.306,171,307,.557,.529,73,89,.820,67,234,301,203,30,18,76,91,529
241,Damian Jones\jonesda03,C,24,ATL,29,19,522,82,120,.683,2,6,.333,80,114,.702,.692,37,53,.698,46,65,111,20,12,27,18,94,203
242,Derrick Jones\jonesde02,SF,22,MIA,17,0,371,48,94,.511,9,33,.273,39,61,.639,.559,28,38,.737,14,47,61,16,18,9,12,40,133
243,Tyus Jones\jonesty01,PG,23,MEM,32,6,636,82,192,.427,18,53,.340,64,139,.460,.474,21,28,.750,4,49,53,151,29,4,34,26,203
244,DeAndre Jordan\jordade01,C,31,BRK,27,3,571,89,139,.640,0,0,,89,139,.640,.640,43,64,.672,66,199,265,59,12,25,33,54,221
245,Cory Joseph\josepco01,PG,28,SAC,31,19,834,74,199,.372,18,60,.300,56,139,.403,.417,25,28,.893,17,70,87,123,24,14,43,62,191
246,Mfiondu Kabengele\kabenmf01,C,22,LAC,10,0,44,10,22,.455,6,12,.500,4,10,.400,.591,3,3,1.000,1,7,8,1,1,1,1,6,29
247,Frank Kaminsky\kaminfr01,C,26,PHO,31,13,711,127,278,.457,39,112,.348,88,166,.530,.527,59,88,.670,30,128,158,71,13,10,33,69,352
248,Enes Kanter\kanteen01,C,27,BOS,22,3,385,76,137,.555,0,2,.000,76,135,.563,.555,30,45,.667,67,99,166,24,14,14,18,33,182
249,Luke Kennard\kennalu01,SG,23,DET,28,25,922,151,342,.442,73,183,.399,78,159,.491,.548,67,75,.893,9,89,98,115,12,6,43,65,442
250,Stanton Kidd\kiddst01,SF,27,UTA,4,0,15,0,3,.000,0,1,.000,0,2,.000,.000,0,0,,0,3,3,1,0,0,2,3,0
251,Michael Kidd-Gilchrist\kiddgmi01,PF,26,CHO,10,0,147,16,49,.327,5,17,.294,11,32,.344,.378,7,9,.778,8,23,31,9,0,3,6,17,44
252,Louis King\kinglo02,F,20,DET,1,0,4,1,3,.333,0,1,.000,1,2,.500,.333,0,0,,0,1,1,0,1,0,0,0,2
253,Maxi Kleber\klebima01,C,28,DAL,29,5,700,83,185,.449,41,108,.380,42,77,.545,.559,32,36,.889,47,111,158,29,8,20,22,64,239
254,Brandon Knight\knighbr03,PG,28,CLE,10,0,114,16,47,.340,12,35,.343,4,12,.333,.468,3,8,.375,1,7,8,16,4,1,8,9,47
255,Kevin Knox\knoxke01,SF,20,NYK,31,4,623,85,220,.386,40,116,.345,45,104,.433,.477,38,56,.679,12,78,90,37,18,16,25,50,248
256,John Konchar\konchjo01,SG,23,MEM,1,0,7,0,0,,0,0,,0,0,,,0,0,,0,0,0,0,0,0,0,0,0
257,Furkan Korkmaz\korkmfu01,SG,22,PHI,33,11,687,102,233,.438,54,140,.386,48,93,.516,.554,19,25,.760,7,66,73,25,18,7,22,48,277
258,Luke Kornet\kornelu01,C,24,CHI,15,0,143,15,48,.313,5,27,.185,10,21,.476,.365,5,5,1.000,6,16,22,6,2,10,3,13,40
259,Kyle Korver\korveky01,SF,38,MIL,28,0,457,56,143,.392,45,116,.388,11,27,.407,.549,16,19,.842,7,42,49,28,15,6,22,31,173
260,Rodions Kurucs\kurucro01,PF,21,BRK,15,0,153,15,36,.417,6,12,.500,9,24,.375,.500,5,10,.500,8,28,36,4,6,1,16,23,41
261,Kyle Kuzma\kuzmaky01,PF,24,LAL,22,1,511,96,219,.438,37,102,.363,59,117,.504,.523,33,47,.702,11,65,76,17,8,10,37,36,262
262,Skal Labissière\labissk01,C,23,POR,32,0,564,81,146,.555,3,12,.250,78,134,.582,.565,25,33,.758,65,103,168,42,7,31,30,87,190
263,Jeremy Lamb\lambje01,SG,27,IND,21,21,640,112,243,.461,24,78,.308,88,165,.533,.510,46,55,.836,12,85,97,51,27,13,31,46,294
264,Romeo Langford\langfro01,SG,20,BOS,6,0,82,7,16,.438,2,7,.286,5,9,.556,.500,3,4,.750,4,3,7,1,3,2,2,6,19
265,Zach LaVine\lavinza01,SG,24,CHI,32,32,1069,254,590,.431,98,248,.395,156,342,.456,.514,150,181,.829,24,122,146,123,42,14,110,76,756
266,Jake Layman\laymaja01,PF,25,MIN,14,2,369,61,132,.462,19,54,.352,42,78,.538,.534,6,10,.600,12,29,41,11,12,10,18,31,147
267,T.J. Leaf\leaftj01,PF,22,IND,19,1,168,26,61,.426,5,13,.385,21,48,.438,.467,6,10,.600,20,38,58,6,7,3,6,15,63
268,Courtney Lee\leeco01,SG,34,DAL,8,3,69,13,22,.591,7,12,.583,6,10,.600,.750,0,0,,0,3,3,3,0,2,2,5,33
269,Damion Lee\leeda03,SG,27,GSW,19,6,471,72,177,.407,24,68,.353,48,109,.440,.475,58,65,.892,17,78,95,41,16,0,22,36,226
270,Alex Len\lenal01,C,26,ATL,30,9,532,101,184,.549,12,40,.300,89,144,.618,.582,35,51,.686,49,107,156,33,15,23,31,68,249
271,Kawhi Leonard\leonaka01,SF,28,LAC,24,24,759,217,466,.466,44,115,.383,173,351,.493,.513,144,164,.878,28,164,192,122,43,14,83,48,622
272,Meyers Leonard\leoname01,PF,27,MIA,31,31,574,71,129,.550,28,61,.459,43,68,.632,.659,8,13,.615,16,124,140,31,7,13,23,63,178
273,Caris LeVert\leverca01,SG,25,BRK,9,9,284,59,140,.421,13,36,.361,46,104,.442,.468,20,31,.645,10,35,45,36,6,1,31,20,151
274,Damian Lillard\lillada01,PG,29,POR,30,30,1102,253,571,.443,101,282,.358,152,289,.526,.532,199,222,.896,14,111,125,226,29,12,87,58,806
275,Nassir Little\littlna01,PF,19,POR,21,3,298,32,79,.405,5,30,.167,27,49,.551,.437,16,24,.667,21,46,67,12,8,7,9,38,85
276,Kevon Looney\looneke01,C,23,GSW,10,3,105,11,32,.344,1,2,.500,10,30,.333,.359,3,5,.600,15,14,29,4,3,2,6,17,26
277,Brook Lopez\lopezbr01,C,31,MIL,31,31,818,110,272,.404,48,150,.320,62,122,.508,.493,53,59,.898,20,136,156,49,20,74,29,70,321
278,Robin Lopez\lopezro01,C,31,MIL,33,2,464,71,144,.493,15,52,.288,56,92,.609,.545,15,27,.556,31,54,85,22,6,22,33,48,172
279,Kevin Love\loveke01,PF,31,CLE,27,27,826,146,324,.451,65,169,.385,81,155,.523,.551,95,113,.841,26,260,286,79,16,10,73,36,452
280,Kyle Lowry\lowryky01,PG,33,TOR,20,20,762,121,291,.416,61,167,.365,60,124,.484,.521,104,121,.860,12,90,102,152,24,7,62,57,407
281,Timothé Luwawu-Cabarrot\luwawti01,SG,24,BRK,8,0,124,10,28,.357,3,12,.250,7,16,.438,.411,9,10,.900,1,10,11,3,3,1,8,10,32
282,Trey Lyles\lylestr01,PF,24,SAS,30,20,509,54,122,.443,24,67,.358,30,55,.545,.541,8,13,.615,33,139,172,38,7,9,20,33,140
283,Daryl Macon\maconda01,SG,24,MIA,4,0,14,1,3,.333,1,2,.500,0,1,.000,.500,0,0,,0,0,0,1,0,0,2,1,3
284,Josh Magette\magetjo01,PG,30,ORL,3,0,10,2,6,.333,0,0,,2,6,.333,.333,1,2,.500,1,2,3,2,2,0,3,0,5
285,Ian Mahinmi\mahinia01,C,33,WAS,10,7,199,25,52,.481,1,7,.143,24,45,.533,.490,23,35,.657,26,33,59,10,6,13,16,33,74
286,Thon Maker\makerth01,C,22,DET,30,3,339,34,66,.515,8,20,.400,26,46,.565,.576,33,51,.647,19,41,60,14,9,18,18,43,109
287,Terance Mann\mannte01,SG,23,LAC,22,5,203,21,42,.500,2,9,.222,19,33,.576,.524,8,10,.800,3,22,25,28,6,3,12,26,52
288,Boban Marjanović\marjabo01,C,31,DAL,13,1,137,31,56,.554,0,1,.000,31,55,.564,.554,14,20,.700,15,43,58,7,2,3,11,20,76
289,Lauri Markkanen\markkla01,PF,22,CHI,32,32,974,156,380,.411,64,193,.332,92,187,.492,.495,93,113,.823,34,182,216,55,28,20,58,63,469
290,Caleb Martin\martica02,SF,24,CHO,5,0,32,3,10,.300,0,3,.000,3,7,.429,.300,3,5,.600,1,4,5,3,1,2,3,3,9
291,Cody Martin\martico01,SF,24,CHO,25,0,377,35,85,.412,7,33,.212,28,52,.538,.453,28,40,.700,12,56,68,32,21,4,14,41,105
292,Kelan Martin\martike03,SF,24,MIN,11,0,144,19,52,.365,8,30,.267,11,22,.500,.442,0,0,,3,24,27,5,2,1,5,22,46
293,Frank Mason\masonfr01,PG,25,MIL,4,0,18,1,7,.143,1,4,.250,0,3,.000,.214,2,4,.500,1,1,2,5,1,0,1,2,5
294,Garrison Mathews\mathega01,SG,23,WAS,9,0,92,8,19,.421,7,18,.389,1,1,1.000,.605,7,8,.875,4,10,14,6,2,1,5,11,30
295,Wesley Matthews\matthwe02,SG,33,MIL,32,32,768,85,199,.427,52,136,.382,33,63,.524,.558,30,36,.833,7,70,77,44,23,5,22,48,252
296,Patrick McCaw\mccawpa01,SF,24,TOR,10,4,240,17,43,.395,7,23,.304,10,20,.500,.477,3,4,.750,5,15,20,12,12,0,12,18,44
297,CJ McCollum\mccolcj01,SG,28,POR,32,32,1171,284,626,.454,87,229,.380,197,397,.496,.523,63,77,.818,25,117,142,116,27,24,64,84,718
298,T.J. McConnell\mccontj01,PG,27,IND,30,0,539,98,191,.513,3,10,.300,95,181,.525,.521,14,17,.824,14,66,80,150,19,5,41,32,213
299,Jalen McDaniels\mcdanja01,PF,22,CHO,2,0,7,2,5,.400,0,1,.000,2,4,.500,.400,0,0,,1,0,1,0,0,0,0,0,4
300,Doug McDermott\mcderdo01,PF,28,IND,32,0,676,116,245,.473,62,133,.466,54,112,.482,.600,19,24,.792,15,77,92,38,4,3,22,63,313
301,JaVale McGee\mcgeeja01,C,32,LAL,31,31,514,97,155,.626,1,1,1.000,96,154,.623,.629,21,34,.618,61,124,185,19,16,46,26,73,216
302,Rodney McGruder\mcgruro01,SG,28,LAC,21,2,368,31,82,.378,15,49,.306,16,33,.485,.470,6,12,.500,13,46,59,14,10,4,9,39,83
303,Alfonzo McKinnie\mckinal01,SF,27,CLE,20,0,190,19,54,.352,8,25,.320,11,29,.379,.426,7,11,.636,11,26,37,3,7,3,8,22,53
304,Jordan McLaughlin\mclaujo01,PG,23,MIN,5,0,80,11,28,.393,4,14,.286,7,14,.500,.464,4,4,1.000,1,8,9,12,4,0,4,5,30
305,Ben McLemore\mclembe01,SG,26,HOU,31,8,739,104,253,.411,77,215,.358,27,38,.711,.563,32,41,.780,10,61,71,31,22,8,25,64,317
306,Jordan McRae\mcraejo01,SG,28,WAS,14,0,250,48,101,.475,14,36,.389,34,65,.523,.545,21,25,.840,4,29,33,38,8,5,15,27,131
307,Nicolò Melli\mellini01,C,29,NOP,25,3,366,42,105,.400,22,72,.306,20,33,.606,.505,21,28,.750,14,47,61,26,14,5,18,45,127
308,De'Anthony Melton\meltode01,PG,21,MEM,21,0,346,50,117,.427,11,31,.355,39,86,.453,.474,31,37,.838,18,62,80,67,28,4,34,40,142
309,Chimezie Metu\metuch01,PF,22,SAS,9,0,34,11,20,.550,0,0,,11,20,.550,.550,2,4,.500,8,8,16,2,1,3,1,1,24
310,Khris Middleton\middlkh01,SF,28,MIL,26,23,722,182,369,.493,57,137,.416,125,232,.539,.570,64,72,.889,24,122,146,96,24,5,51,61,485
311,C.J. Miles\milescj01,SG,32,WAS,10,0,161,19,59,.322,11,35,.314,8,24,.333,.415,15,20,.750,4,8,12,12,10,4,4,14,64
312,Malcolm Miller\millema01,SF,26,TOR,17,1,106,6,19,.316,5,15,.333,1,4,.250,.447,1,6,.167,1,13,14,7,4,2,3,10,18
313,Patty Mills\millspa02,PG,31,SAS,30,1,699,121,265,.457,66,158,.418,55,107,.514,.581,40,52,.769,7,38,45,61,27,5,31,45,348
314,Paul Millsap\millspa01,PF,34,DEN,28,28,697,121,250,.484,30,65,.462,91,185,.492,.544,75,85,.882,52,109,161,39,24,20,37,76,347
315,Shake Milton\miltosh01,SG,23,PHI,10,0,83,13,36,.361,4,19,.211,9,17,.529,.417,7,9,.778,1,7,8,7,1,0,12,13,37
316,Donovan Mitchell\mitchdo01,SG,23,UTA,31,31,1086,289,636,.454,67,191,.351,222,445,.499,.507,133,160,.831,26,115,141,127,36,9,76,73,778
317,Naz Mitrou-Long\mitrona01,SG,26,IND,3,0,43,6,16,.375,2,11,.182,4,5,.800,.438,0,0,,0,6,6,7,1,1,2,1,14
318,Malik Monk\monkma01,SG,21,CHO,33,0,665,115,261,.441,32,120,.267,83,141,.589,.502,38,46,.826,12,79,91,73,15,6,44,48,300
319,E'Twaun Moore\mooreet01,SG,30,NOP,20,3,395,71,167,.425,27,66,.409,44,101,.436,.506,14,22,.636,15,45,60,31,9,2,11,29,183
320,Ja Morant\moranja01,PG,20,MEM,26,26,760,173,369,.469,24,61,.393,149,308,.484,.501,96,121,.793,18,66,84,166,29,8,81,44,466
321,Juwan Morgan\morgaju01,PF,22,UTA,3,0,9,0,0,,0,0,,0,0,,,0,0,,0,2,2,0,0,0,1,1,0
322,Marcus Morris\morrima03,SF,30,NYK,29,29,920,176,406,.433,76,165,.461,100,241,.415,.527,110,128,.859,32,132,164,41,24,13,50,89,538
323,Markieff Morris\morrima02,PF,30,DET,31,15,698,124,264,.470,53,129,.411,71,135,.526,.570,35,47,.745,17,105,122,52,19,7,53,71,336
324,Monte Morris\morrimo01,PG,24,DEN,30,0,531,83,196,.423,18,44,.409,65,152,.428,.469,25,33,.758,9,39,48,100,20,8,20,24,209
325,Johnathan Motley\motlejo01,PF,24,LAC,4,0,11,1,3,.333,1,1,1.000,0,2,.000,.500,0,0,,1,1,2,3,3,0,3,3,3
326,Emmanuel Mudiay\mudiaem01,PG,23,UTA,28,0,461,79,167,.473,15,43,.349,64,124,.516,.518,31,41,.756,8,62,70,67,9,7,44,46,204
327,Dejounte Murray\murrade01,PG,23,SAS,27,19,634,112,232,.483,8,34,.235,104,198,.525,.500,43,55,.782,31,128,159,110,49,9,63,67,275
328,Jamal Murray\murraja01,PG,22,DEN,30,30,955,197,451,.437,50,154,.325,147,297,.495,.492,81,90,.900,29,101,130,135,42,8,69,52,525
329,Džanan Musa\musadz01,SF,20,BRK,23,0,307,32,100,.320,9,50,.180,23,50,.460,.365,23,31,.742,10,41,51,24,9,1,24,17,96
330,Mike Muscala\muscami01,C,28,OKC,20,0,200,19,65,.292,12,48,.250,7,17,.412,.385,9,10,.900,7,33,40,14,4,3,6,21,59
331,Sviatoslav Mykhailiuk\mykhasv01,SF,22,DET,27,4,469,55,137,.401,43,100,.430,12,37,.324,.558,11,14,.786,6,30,36,39,13,2,22,36,164
332,Abdel Nader\naderab01,SF,26,OKC,24,5,436,60,127,.472,26,65,.400,34,62,.548,.575,24,30,.800,8,34,42,17,9,9,23,36,170
333,Larry Nance\nancela02,C,27,CLE,28,4,684,90,183,.492,28,82,.341,62,101,.614,.568,26,39,.667,48,151,199,43,21,14,26,43,234
334,Shabazz Napier\napiesh01,PG,28,MIN,17,3,317,40,113,.354,16,73,.219,24,40,.600,.425,24,29,.828,3,34,37,64,20,4,28,19,120
335,Raul Neto\netora01,PG,27,PHI,28,2,325,44,90,.489,16,35,.457,28,55,.509,.578,6,8,.750,3,26,29,42,14,2,25,20,110
336,Georges Niang\niangge01,PF,26,UTA,25,0,296,41,88,.466,23,56,.411,18,32,.563,.597,7,10,.700,5,38,43,10,4,3,13,34,112
337,Nerlens Noel\noelne01,C,25,OKC,30,3,555,89,135,.659,0,0,,89,135,.659,.659,50,62,.806,43,103,146,39,32,43,33,81,228
338,Zach Norvell\norveza01,SG,22,LAL,2,0,5,0,1,.000,0,0,,0,1,.000,.000,0,0,,0,1,1,0,0,0,0,0,0
339,Jaylen Nowell\nowelja01,SG,20,MIN,5,0,59,7,16,.438,0,9,.000,7,7,1.000,.438,5,5,1.000,0,2,2,5,0,0,1,2,19
340,Frank Ntilikina\ntilila01,PG,21,NYK,30,23,682,65,171,.380,25,75,.333,40,96,.417,.453,16,20,.800,11,48,59,86,35,11,37,80,171
341,Kendrick Nunn\nunnke01,SG,24,MIA,31,31,955,201,446,.451,66,187,.353,135,259,.521,.525,36,46,.783,9,77,86,111,30,7,61,76,504
342,David Nwaba\nwabada01,SF,27,BRK,20,0,268,37,71,.521,12,28,.429,25,43,.581,.606,18,27,.667,8,37,45,8,11,12,8,32,104
343,Royce O'Neale\onealro01,PF,26,UTA,31,28,910,72,154,.468,41,94,.436,31,60,.517,.601,14,18,.778,5,145,150,80,27,9,27,93,199
344,Kyle O'Quinn\oquinky01,C,29,PHI,18,0,170,24,48,.500,6,16,.375,18,32,.563,.563,3,8,.375,19,42,61,23,2,13,16,24,57
345,Semi Ojeleye\ojelese01,PF,25,BOS,29,4,434,26,67,.388,15,42,.357,11,25,.440,.500,7,10,.700,10,46,56,14,11,2,6,35,74
346,Jahlil Okafor\okafoja01,C,24,NOP,19,8,332,63,104,.606,1,2,.500,62,102,.608,.611,28,43,.651,32,55,87,29,5,15,30,53,155
347,Elie Okobo\okoboel01,PG,22,PHO,22,1,253,39,88,.443,12,33,.364,27,55,.491,.511,24,39,.615,4,22,26,48,10,2,9,20,114
348,Josh Okogie\okogijo01,SG,21,MIN,28,12,686,71,178,.399,20,71,.282,51,107,.477,.455,67,85,.788,38,92,130,40,25,11,42,60,229
349,KZ Okpala\okpalkz01,SF,20,MIA,3,0,3,0,0,,0,0,,0,0,,,0,0,,0,1,1,0,0,0,1,0,0
350,Kelly Olynyk\olynyke01,C,28,MIA,31,0,679,86,188,.457,48,112,.429,38,76,.500,.585,45,51,.882,25,128,153,41,24,10,39,83,265
351,Miye Oni\onimi01,SG,22,UTA,3,0,8,0,0,,0,0,,0,0,,,0,0,,0,1,1,0,0,0,1,0,0
352,Cedi Osman\osmande01,SF,24,CLE,31,31,893,117,271,.432,51,139,.367,66,132,.500,.526,24,39,.615,13,87,100,68,32,10,42,65,309
353,Kelly Oubre\oubreke01,SF,24,PHO,31,31,1016,189,426,.444,47,150,.313,142,276,.514,.499,111,139,.799,38,141,179,48,43,24,53,101,536
354,Jabari Parker\parkeja01,PF,24,ATL,31,23,822,196,387,.506,31,112,.277,165,275,.600,.547,53,72,.736,52,137,189,55,41,15,60,91,476
355,Chandler Parsons\parsoch01,SF,31,ATL,5,0,54,5,18,.278,4,14,.286,1,4,.250,.389,0,0,,1,6,7,3,4,1,3,3,14
356,Eric Paschall\pascher01,PF,23,GSW,29,19,819,158,321,.492,20,65,.308,138,256,.539,.523,89,113,.788,42,94,136,49,12,10,43,57,425
357,Anžejs Pasečņiks\pasecan01,C,24,WAS,5,0,107,20,34,.588,0,0,,20,34,.588,.588,11,17,.647,10,13,23,4,2,0,3,14,51
358,Patrick Patterson\pattepa01,PF,30,LAC,30,14,448,54,130,.415,40,99,.404,14,31,.452,.569,17,24,.708,25,71,96,24,5,3,11,23,165
359,Justin Patton\pattoju01,C,22,OKC,2,0,9,1,3,.333,0,1,.000,1,2,.500,.333,0,0,,0,2,2,0,0,0,1,4,2
360,Chris Paul\paulch01,PG,34,OKC,31,31,980,169,362,.467,48,131,.366,121,231,.524,.533,119,132,.902,10,132,142,200,51,5,56,75,505
361,Elfrid Payton\paytoel01,PG,25,NYK,15,6,352,50,124,.403,9,27,.333,41,97,.423,.440,11,17,.647,18,38,56,87,25,3,24,30,120
362,Gary Payton\paytoga02,G,27,WAS,2,0,65,8,16,.500,3,4,.750,5,12,.417,.594,1,2,.500,7,9,16,10,7,2,3,4,20
363,Norvel Pelle\pelleno01,SF,26,PHI,7,0,63,6,9,.667,0,0,,6,9,.667,.667,4,6,.667,4,15,19,4,0,9,6,12,16
364,Theo Pinson\pinsoth01,SG,24,BRK,20,0,273,33,115,.287,12,58,.207,21,57,.368,.339,13,14,.929,8,33,41,39,9,2,27,27,91
365,Mason Plumlee\plumlma01,C,29,DEN,30,0,515,81,139,.583,0,4,.000,81,135,.600,.583,35,65,.538,54,117,171,72,18,22,46,66,197
366,Vincent Poirier\poirivi01,C,26,BOS,9,0,44,7,14,.500,0,0,,7,14,.500,.500,1,2,.500,8,7,15,3,2,2,3,10,15
367,Jakob Pöltl\poeltja01,C,24,SAS,30,7,545,72,121,.595,0,0,,72,121,.595,.595,22,42,.524,63,109,172,52,16,43,26,52,166
368,Shamorie Ponds\pondssh01,PG,21,TOR,3,0,9,2,4,.500,0,1,.000,2,3,.667,.500,0,0,,0,1,1,2,0,1,0,2,4
369,Jordan Poole\poolejo01,SG,20,GSW,29,9,630,63,248,.254,32,132,.242,31,116,.267,.319,47,56,.839,4,53,57,53,17,7,31,48,205
370,Kevin Porter\porteke02,SF,19,CLE,30,1,640,95,212,.448,26,80,.325,69,132,.523,.509,35,45,.778,10,85,95,59,27,5,50,76,251
371,Michael Porter\portemi01,PF,21,DEN,21,0,179,36,81,.444,9,27,.333,27,54,.500,.500,8,11,.727,17,38,55,9,1,7,13,25,89
372,Otto Porter\porteot01,SF,26,CHI,9,9,226,35,84,.417,16,40,.400,19,44,.432,.512,15,20,.750,8,23,31,14,9,3,7,20,101
373,Bobby Portis\portibo01,C,24,NYK,32,2,690,118,279,.423,33,94,.351,85,185,.459,.482,32,43,.744,46,143,189,40,20,9,31,59,301
374,Kristaps Porziņģis\porzikr01,PF,24,DAL,29,29,912,180,450,.400,61,182,.335,119,268,.444,.468,85,118,.720,54,223,277,42,17,61,45,86,506
375,Dwight Powell\poweldw01,C,28,DAL,27,24,700,88,144,.611,9,27,.333,79,117,.675,.642,43,68,.632,42,99,141,38,21,14,22,67,228
376,Norman Powell\powelno01,SG,26,TOR,27,16,780,140,284,.493,51,131,.389,89,153,.582,.583,57,69,.826,15,90,105,46,30,11,43,52,388
377,Julius Randle\randlju01,PF,25,NYK,32,32,1018,215,474,.454,37,128,.289,178,346,.514,.493,121,175,.691,72,204,276,102,22,4,91,87,588
378,Cam Reddish\reddica01,SF,20,ATL,29,19,750,86,262,.328,31,116,.267,55,146,.377,.387,45,59,.763,18,93,111,42,29,12,52,55,248
379,J.J. Redick\redicjj01,SG,35,NOP,30,26,865,149,333,.447,97,212,.458,52,121,.430,.593,80,91,.879,6,83,89,58,11,6,37,49,475
380,Naz Reid\reidna01,C,20,MIN,2,0,4,1,2,.500,1,2,.500,0,0,,.750,0,0,,0,1,1,0,0,0,0,1,3
381,Josh Richardson\richajo01,SG,26,PHI,26,26,814,144,334,.431,46,130,.354,98,204,.480,.500,50,64,.781,24,66,90,86,29,17,55,72,384
382,Austin Rivers\riverau01,SG,27,HOU,29,1,679,86,210,.410,36,115,.313,50,95,.526,.495,25,36,.694,18,56,74,44,16,6,15,56,233
383,Duncan Robinson\robindu01,SF,25,MIA,31,26,846,125,260,.481,101,222,.455,24,38,.632,.675,19,20,.950,5,90,95,29,19,10,18,85,370
384,Glenn Robinson\robingl02,SF,26,GSW,32,32,1024,149,325,.458,41,102,.402,108,223,.484,.522,38,44,.864,48,102,150,51,32,8,28,57,377
385,Jerome Robinson\robinje01,SG,22,LAC,25,0,305,34,99,.343,13,46,.283,21,53,.396,.409,6,13,.462,3,38,41,25,7,7,18,36,87
386,Justin Robinson\robinju01,PG,22,WAS,8,0,45,5,11,.455,3,5,.600,2,6,.333,.591,0,0,,1,4,5,6,0,1,3,2,13
387,Mitchell Robinson\robinmi01,C,21,NYK,28,7,640,115,168,.685,0,0,,115,168,.685,.685,52,82,.634,90,108,198,15,22,54,19,100,282
388,Rajon Rondo\rondora01,PG,33,LAL,19,1,415,54,135,.400,23,58,.397,31,77,.403,.485,12,17,.706,9,60,69,109,23,1,40,24,143
389,Derrick Rose\rosede01,PG,31,DET,26,1,631,174,358,.486,24,77,.312,150,281,.534,.520,55,63,.873,15,42,57,156,21,9,63,25,427
390,Terrence Ross\rosste01,SG,28,ORL,29,0,721,132,323,.409,61,180,.339,71,143,.497,.503,57,66,.864,8,76,84,27,27,8,32,47,382
391,Terry Rozier\roziete01,PG,25,CHO,34,34,1132,214,515,.416,86,225,.382,128,290,.441,.499,83,99,.838,29,125,154,142,42,7,89,77,597
392,Ricky Rubio\rubiori01,PG,29,PHO,25,25,795,125,305,.410,28,93,.301,97,212,.458,.456,67,79,.848,18,101,119,230,31,4,64,62,345
393,D'Angelo Russell\russeda01,SG,23,GSW,21,21,660,166,392,.423,65,190,.342,101,202,.500,.506,79,103,.767,6,64,70,127,19,8,65,46,476
394,Domantas Sabonis\sabondo01,C,23,IND,30,30,1029,209,415,.504,8,30,.267,201,385,.522,.513,97,132,.735,99,299,398,118,24,18,78,107,523
395,JaKarr Sampson\sampsja02,SF,26,IND,10,7,171,24,42,.571,2,10,.200,22,32,.688,.595,2,7,.286,7,20,27,4,5,6,6,24,52
396,Dario Šarić\saricda01,PF,25,PHO,31,31,859,133,294,.452,50,146,.342,83,148,.561,.537,44,51,.863,55,174,229,66,23,10,43,82,360
397,Tomáš Satoranský\satorto01,PG,28,CHI,32,32,901,117,256,.457,39,99,.394,78,157,.497,.533,48,55,.873,30,88,118,168,47,5,67,59,321
398,Admiral Schofield\schofad01,SF,22,WAS,17,2,220,21,53,.396,11,34,.324,10,19,.526,.500,8,10,.800,4,21,25,12,7,3,6,32,61
399,Dennis Schröder\schrode01,PG,26,OKC,31,0,935,217,463,.469,55,159,.346,162,304,.533,.528,80,97,.825,8,111,119,115,22,10,92,68,569
400,Mike Scott\scottmi01,PF,31,PHI,34,4,633,77,176,.438,43,119,.361,34,57,.596,.560,12,15,.800,23,86,109,21,11,2,13,44,209
401,Thabo Sefolosha\sefolth01,PF,35,HOU,23,0,227,16,48,.333,8,29,.276,8,19,.421,.417,0,1,.000,12,36,48,15,9,4,7,21,40
402,Collin Sexton\sextoco01,SG,21,CLE,31,31,945,217,479,.453,26,94,.277,191,385,.496,.480,95,115,.826,31,66,97,75,30,2,60,64,555
403,Landry Shamet\shamela01,SG,22,LAC,16,11,436,46,111,.414,31,82,.378,15,29,.517,.554,20,21,.952,1,28,29,26,7,4,16,49,143
404,Iman Shumpert\shumpim01,SG,29,BRK,13,0,241,21,64,.328,8,33,.242,13,31,.419,.391,4,7,.571,9,25,34,12,12,2,10,21,54
405,Pascal Siakam\siakapa01,PF,25,TOR,27,27,989,253,554,.457,67,171,.392,186,383,.486,.517,104,128,.813,38,179,217,97,26,26,72,77,677
406,Chris Silva\silvach01,PF,23,MIA,25,0,237,34,51,.667,0,2,.000,34,49,.694,.667,28,40,.700,44,45,89,15,6,15,28,62,96
407,Ben Simmons\simmobe01,PG,23,PHI,32,32,1118,188,334,.563,2,5,.400,186,329,.565,.566,81,139,.583,53,172,225,276,71,20,118,108,459
408,Anfernee Simons\simonan01,SG,20,POR,32,1,694,114,273,.418,40,120,.333,74,153,.484,.491,36,47,.766,13,64,77,44,12,5,29,70,304
409,Alen Smailagić\smailal01,F,19,GSW,1,0,5,2,3,.667,0,1,.000,2,2,1.000,.667,0,0,,1,0,1,0,0,1,0,0,4
410,Marcus Smart\smartma01,SG,25,BOS,20,15,635,82,212,.387,42,126,.333,40,86,.465,.486,29,33,.879,19,48,67,91,26,9,25,46,235
411,Dennis Smith\smithde03,PG,22,NYK,21,1,339,41,126,.325,12,41,.293,29,85,.341,.373,15,30,.500,13,31,44,57,10,7,30,44,109
412,Ish Smith\smithis01,PG,31,WAS,30,12,762,123,271,.454,28,75,.373,95,196,.485,.506,21,32,.656,15,69,84,127,22,12,38,46,295
413,Tony Snell\snellto01,SF,28,DET,28,26,739,82,180,.456,56,130,.431,26,50,.520,.611,12,12,1.000,6,45,51,38,13,4,14,47,232
414,Omari Spellman\spellom01,PF,22,GSW,31,0,515,74,173,.428,19,54,.352,55,119,.462,.483,39,48,.813,61,94,155,26,17,17,36,30,206
415,Max Strus\strusma01,SG,23,CHI,2,0,6,2,3,.667,0,1,.000,2,2,1.000,.667,1,1,1.000,1,0,1,0,0,0,0,1,5
416,Edmond Sumner\sumneed01,PG,24,IND,9,2,143,18,41,.439,4,14,.286,14,27,.519,.488,4,7,.571,6,9,15,18,7,4,6,16,44
417,Caleb Swanigan\swanica01,PF,22,SAC,5,0,13,1,2,.500,0,0,,1,2,.500,.500,1,2,.500,1,4,5,0,1,2,4,3,3
418,Jayson Tatum\tatumja01,PF,21,BOS,29,29,988,228,543,.420,74,204,.363,154,339,.454,.488,95,112,.848,36,170,206,83,39,24,62,65,625
419,Jeff Teague\teaguje01,PG,31,MIN,26,13,766,115,256,.449,28,72,.389,87,184,.473,.504,108,125,.864,13,63,76,169,20,11,59,55,366
420,Garrett Temple\templga01,SG,33,BRK,30,21,875,114,291,.392,66,196,.337,48,95,.505,.505,31,41,.756,18,85,103,74,27,14,35,57,325
421,Daniel Theis\theisda01,C,27,BOS,26,25,563,76,142,.535,9,28,.321,67,114,.588,.567,26,37,.703,43,119,162,35,13,40,22,87,187
422,Isaiah Thomas\thomais02,PG,30,WAS,21,18,532,105,235,.447,46,108,.426,59,127,.465,.545,30,37,.811,3,33,36,101,9,5,46,44,286
423,Khyri Thomas\thomakh01,SG,23,DET,2,0,6,0,0,,0,0,,0,0,,,1,2,.500,0,0,0,0,0,0,0,0,1
424,Matt Thomas\thomama02,SG,25,TOR,12,0,136,20,37,.541,14,26,.538,6,11,.545,.730,3,5,.600,1,12,13,4,4,0,4,12,57
425,Tristan Thompson\thomptr01,C,28,CLE,30,30,936,167,327,.511,3,7,.429,164,320,.513,.515,48,87,.552,119,179,298,68,25,30,53,69,385
426,Matisse Thybulle\thybuma01,SG,22,PHI,30,3,529,49,112,.438,31,67,.463,18,45,.400,.576,16,24,.667,8,24,32,37,43,22,28,62,145
427,Anthony Tolliver\tollian01,PF,34,POR,22,8,361,22,71,.310,17,56,.304,5,15,.333,.430,11,14,.786,14,49,63,17,7,6,16,33,72
428,Karl-Anthony Towns\townska01,C,24,MIN,23,23,779,207,403,.514,82,196,.418,125,207,.604,.615,113,142,.796,63,206,269,101,24,29,72,80,609
429,Gary Trent\trentga02,SG,21,POR,19,1,208,23,64,.359,16,42,.381,7,22,.318,.484,4,4,1.000,5,19,24,9,6,3,7,17,66
430,Allonzo Trier\trieral01,PG,24,NYK,15,1,199,34,64,.531,15,35,.429,19,29,.655,.648,31,39,.795,1,20,21,21,2,4,19,23,114
431,P.J. Tucker\tuckepj01,PF,34,HOU,31,31,1120,103,213,.484,58,142,.408,45,71,.634,.620,23,30,.767,48,180,228,45,41,14,33,105,287
432,Evan Turner\turneev01,PG,31,ATL,17,0,226,24,62,.387,0,5,.000,24,57,.421,.387,12,14,.857,7,28,35,35,8,8,24,17,60
433,Myles Turner\turnemy01,C,23,IND,24,24,708,106,231,.459,40,106,.377,66,125,.528,.545,39,54,.722,31,106,137,28,15,53,33,58,291
434,Jonas Valančiūnas\valanjo01,C,27,MEM,29,29,727,177,302,.586,16,39,.410,161,263,.612,.613,47,64,.734,78,204,282,54,8,26,60,76,417
435,Denzel Valentine\valende01,SF,26,CHI,18,0,226,44,106,.415,26,66,.394,18,40,.450,.538,5,5,1.000,3,33,36,19,12,4,10,25,119
436,Jarred Vanderbilt\vandeja01,SF,20,DEN,3,0,9,0,0,,0,0,,0,0,,,0,0,,0,2,2,1,0,0,1,0,0
437,Fred VanVleet\vanvlfr01,PG,25,TOR,26,26,945,153,378,.405,63,171,.368,90,207,.435,.488,102,117,.872,6,96,102,181,53,5,67,56,471
438,Noah Vonleh\vonleno01,C,24,MIN,21,1,260,31,61,.508,1,13,.077,30,48,.625,.516,20,24,.833,25,56,81,20,7,4,16,27,83
439,Nikola Vučević\vucevni01,C,29,ORL,20,20,623,139,310,.448,25,79,.316,114,231,.494,.489,48,61,.787,54,166,220,70,16,20,23,39,351
440,Dean Wade\wadede01,PF,23,CLE,3,0,18,1,2,.500,1,1,1.000,0,1,.000,.750,0,0,,0,2,2,0,1,0,0,3,3
441,Moritz Wagner\wagnemo01,C,22,WAS,21,4,429,93,160,.581,22,56,.393,71,104,.683,.650,36,43,.837,34,93,127,28,15,13,43,81,244
442,Kemba Walker\walkeke02,PG,29,BOS,28,28,900,204,477,.428,103,256,.402,101,221,.457,.536,112,128,.875,23,88,111,148,23,17,67,47,623
443,Lonnie Walker\walkelo01,SG,21,SAS,22,0,218,40,90,.444,8,22,.364,32,68,.471,.489,13,22,.591,8,28,36,12,6,3,14,21,101
444,Tyrone Wallace\wallaty01,SG,25,ATL,14,0,160,14,44,.318,1,15,.067,13,29,.448,.330,11,17,.647,3,19,22,13,7,1,10,19,40
445,Taurean Waller-Prince\princta02,SF,25,BRK,30,30,914,131,351,.373,72,198,.364,59,153,.386,.476,29,38,.763,25,171,196,66,26,13,61,83,363
446,Derrick Walton\waltode01,PG,24,LAC,15,0,150,11,22,.500,6,14,.429,5,8,.625,.636,6,7,.857,2,8,10,17,4,0,3,12,34
447,Brad Wanamaker\wanambr01,PG,30,BOS,29,0,545,64,143,.448,14,38,.368,50,105,.476,.497,59,66,.894,11,49,60,85,20,7,34,53,201
448,T.J. Warren\warretj01,SF,26,IND,32,32,1040,226,455,.497,40,109,.367,186,346,.538,.541,72,87,.828,27,90,117,39,31,14,40,83,564
449,PJ Washington\washipj01,PF,21,CHO,29,29,861,134,279,.480,39,98,.398,95,181,.525,.550,50,73,.685,27,125,152,49,28,27,39,78,357
450,Yuta Watanabe\watanyu01,SG,25,MEM,4,0,18,3,6,.500,1,2,.500,2,4,.500,.583,0,0,,1,4,5,0,0,1,1,1,7
451,Tremont Waters\watertr01,PG,22,BOS,3,0,28,5,12,.417,2,7,.286,3,5,.600,.500,2,2,1.000,0,2,2,3,1,2,4,3,14
452,Russell Westbrook\westbru01,PG,31,HOU,28,28,987,249,585,.426,34,143,.238,215,442,.486,.455,144,182,.791,45,182,227,199,43,10,124,107,676
453,Coby White\whiteco01,SG,19,CHI,32,0,765,128,357,.359,59,174,.339,69,183,.377,.441,40,50,.800,9,103,112,75,23,3,45,40,355
454,Derrick White\whitede01,SG,25,SAS,28,10,665,100,208,.481,27,65,.415,73,143,.510,.546,51,64,.797,12,65,77,87,16,17,35,61,278
455,Hassan Whiteside\whiteha01,C,30,POR,29,29,842,184,303,.607,1,2,.500,183,301,.608,.609,74,97,.763,106,278,384,38,13,78,58,86,443
456,Andrew Wiggins\wiggian01,SF,24,MIN,26,26,931,240,538,.446,57,175,.326,183,363,.504,.499,107,143,.748,32,108,140,85,18,29,64,64,644
457,Grant Williams\willigr01,PF,21,BOS,27,1,415,32,87,.368,5,37,.135,27,50,.540,.397,19,23,.826,20,41,61,25,10,15,20,59,88
458,Johnathan Williams\willijo04,F,24,WAS,1,0,33,4,6,.667,0,0,,4,6,.667,.667,1,1,1.000,3,5,8,2,0,1,0,2,9
459,Kenrich Williams\willike04,PF,25,NOP,30,18,732,49,139,.353,25,94,.266,24,45,.533,.442,9,24,.375,47,119,166,51,22,21,20,74,132
460,Lou Williams\willilo02,SG,33,LAC,31,4,936,195,470,.415,54,150,.360,141,320,.441,.472,148,176,.841,12,80,92,191,20,4,95,47,592
461,Marvin Williams\willima02,PF,33,CHO,29,0,599,77,160,.481,36,90,.400,41,70,.586,.594,32,35,.914,13,67,80,32,19,14,20,52,222
462,Robert Williams\williro04,C,22,BOS,19,1,269,33,49,.673,0,0,,33,49,.673,.673,8,14,.571,23,64,87,21,17,21,16,34,74
463,Nigel Williams-Goss\willini01,PG,25,UTA,7,0,22,0,5,.000,0,1,.000,0,4,.000,.000,2,2,1.000,1,1,2,2,0,1,1,1,2
464,D.J. Wilson\wilsodj01,PF,23,MIL,17,0,195,31,66,.470,11,39,.282,20,27,.741,.553,2,3,.667,6,35,41,14,0,2,11,17,75
465,Justise Winslow\winslju01,SF,23,MIA,10,5,337,50,127,.394,6,26,.231,44,101,.436,.417,18,27,.667,16,55,71,43,6,4,23,36,124
466,Christian Wood\woodch01,PF,24,DET,28,0,429,98,155,.632,17,40,.425,81,115,.704,.687,53,80,.663,36,99,135,17,9,23,29,28,266
467,Delon Wright\wrighde01,SG,27,DAL,28,2,573,77,160,.481,17,47,.362,60,113,.531,.534,38,44,.864,24,76,100,92,40,8,20,35,209
468,Thaddeus Young\youngth01,PF,31,CHI,31,0,675,109,275,.396,33,103,.320,76,172,.442,.456,20,34,.588,47,90,137,58,32,8,49,58,271
469,Trae Young\youngtr01,PG,21,ATL,31,31,1082,288,649,.444,106,288,.368,182,361,.504,.525,201,238,.845,16,117,133,257,38,2,146,47,883
470,Cody Zeller\zelleco01,C,27,CHO,31,20,739,141,261,.540,15,52,.288,126,209,.603,.569,64,95,.674,93,148,241,39,20,14,47,81,361
471,Ante Žižić\zizican01,C,23,CLE,10,0,96,18,31,.581,0,0,,18,31,.581,.581,9,10,.900,7,18,25,0,2,3,1,11,45
472,Ivica Zubac\zubaciv01,C,22,LAC,33,31,560,107,181,.591,0,2,.000,107,179,.598,.591,61,84,.726,74,138,212,30,7,30,31,78,275
